W W W W W W W W W W W W W W W W W W W
W F F F F F F F F W F F F F F F F F W
W F W W F W W W W W W W W W F W W F W
W F F F F F F F F F F F F F F F F F W
W F W W F W F W W W W W F W F W W F W
W F F F F W F F F W F F F W F F F F W
W F W W F W W W E W E W W W F W W F W
W F F W F W E E E E E E E W F W F F W
W F W W F W E W W W W W E W F W W F W
W F F F F E E W 1 E 2 W E E F F F F W
W F W W F W E W E W E W E W F W W F W
W F F W F W E E E E E E E W F W F F W
W F W W F W E W W W W W E W F W W F W
W F F F F F F F F W F F F F F F F F W
W F W W F W W W W W W W W W F W W F W
W F F W F F F F F P F F F F F W F F W
W F F W F W F W W W W W F W F W F W W
W F F F F W F F F W F F F W F F F F W
W F W W W W W W F W F W W W W W W F W
W F F F F F F F F F F F F F F F F F W
W W W W W W W W W W W W W W W W W W W